#
# 0 D room1.txt 0
#
WWWWWWWWWW
WGGWTWGGGW
WGGGGGGGGW
WGGGGGGGGW
WWWWWWWW W
WGR GG W W
W A  GGW W
WGG  GSW W
9h   G   W
WWWWWWWWWW